[
	{
		"name": "Level 01",
		"map": [
			"w,w,w,w,w,w,w,w,w,w,w,w,w,w,w,w,w,w,w,w,w,w,w,w,w",
			"w, , , , , , , ,t,t,t,t,t,t,t, , , , , , , , , ,w",
			"w, , , , , , , , , , , , , , , , , , , , , , , ,w",
			"w, , , , , , , , , , , , , , , , , , , , , , , ,w",
			"w, , , , ,c, , , , ,s14,s13,s12,s11, , , , , , , , , , ,w",
			"w, , , , ,c, , , , , , , , , , , , , , , , , , ,w",
			"w, , , , ,c, , , , , , , , , , , , , , , , , , ,w",
			"w, , , , ,c, , , , ,t, , , ,t, , , , , ,c, , , ,w",
			"w, , , , ,c, , , , , , , , , , , , , , , , , , ,w",
			"w, , , , ,c, , , , , , , , , , ,m, , , , , , , ,w",
			"w, , , ,s31, , , , , , , , , , , , , , , ,s44, , , ,w",
			"w, , , ,s32, , , , ,m,m, , , , , , , , , ,s43, , , ,w",
			"w, , , ,s33, , , , , , , , , , , , , , , ,s42, , , ,w",
			"w, , , ,s34, , , ,b, , , , , , , , , , , ,s41, , , ,w",
			"w, , , , , , , , , , , , , , , , , , , , , , , ,w",
			"w, , , , , , , , ,t,t, , ,t, , , , , , , , , , ,w",
			"w, , , , , , ,m, , , , , , ,m, , , , , , , , , ,w",
			"w, , , , , , , ,c, , , , , , , , , , ,t, , , ,a,w",
			"w, , , ,a, , , , , , , , , ,t, , , ,b, , , , , ,w",
			"w, , , , , , , , , , , , , , , , , , , , , , , ,w",
			"w, , , , , , , , , ,s21,s22,s23,s24, , , , , , , , , , ,w",
			"w, , , , , , , , , , , , , , , , , , , , , , , ,w",
			"w, , , , , , , , , , , , , , , , , , , , , , , ,w",
			"w, , , , ,m, , , , , , ,m,m,m,m,m,m, , , , , , ,w",
			"w,w,w,w,w,w,w,w,w,w,w,w,w,w,w,w,w,w,w,w,w,w,w,w,w"],
		"item_rates": {"a": 6, "m": 2, "c": 2, "t": 2, "b": 1, "o": 10},
		"trg_score": 100,
		"profiles": {}
	},
	{
		"name": "Level 02",
		"map": [
			"w,w,w,w,w,w,w,w,w,w,w,w,w,w,w,w,w,w,w,w,w,w,w,w,w",
			"w, , , , , , , , , , , , , , , , , , , , , , , ,w",
			"w, , , , , , , , , , , , , , , , , , , , , , , ,w",
			"w, , ,s14,s13,s12,s11, , , , , ,w, , , , , , , , ,s44, , ,w",
			"w, , , , , , , , , , , ,w, , , , , , , , ,s43, , ,w",
			"w, , , , , , , , , , , ,w, , , , , , , , ,s42, , ,w",
			"w, , , , , , , , , , , ,w, , , , , , , , ,s41, , ,w",
			"w, , , , , , , , , , , ,w, , , , , , , , , , , ,w",
			"w, , , , , , , , , , , ,w, , , , , , , , , , , ,w",
			"w, , , , , , , , , , , ,w, , , , , , , , , , , ,w",
			"w, , , , , , , , , , , ,w, , , , , , , , , , , ,w",
			"w, , , , , , , , , , , , , , , , , , , , , , , ,w",
			"w, , ,w,w,w,w,w,w,w,w, , , ,w,w,w,w,w,w,w,w, , ,w",
			"w, , , , , , , , , , , , , , , , , , , , , , , ,w",
			"w, , , , , , , , , , , ,w, , , , , , , , , , , ,w",
			"w, , , , , , , , , , , ,w, , , , , , , , , , , ,w",
			"w, , , , , , , , , , , ,w, , , , , , , , , , , ,w",
			"w, , , , , , , , , , , ,w, , , , , , , , , , , ,w",
			"w, , ,s31, , , , , , , , ,w, , , , , , , , , , , ,w",
			"w, , ,s32, , , , , , , , ,w, , , , , , , , , , , ,w",
			"w, , ,s33, , , , , , , , ,w, , , , , , , , , , , ,w",
			"w, , ,s34, , , , , , , , ,w, , , , , ,s21,s22,s23,s24, , ,w",
			"w, , , , , , , , , , , , , , , , , , , , , , , ,w",
			"w, , , , , , , , , , , , , , , , , , , , , , , ,w",
			"w,w,w,w,w,w,w,w,w,w,w,w,w,w,w,w,w,w,w,w,w,w,w,w,w"],	
		"item_rates": {"a": 6, "m": 2, "c": 2, "t": 2, "b": 1},
		"trg_score": 100,
		"profiles": {}
	}
]