[
	{
		"name": "A Day In The Sand",
		"id": 0,
		"map": [
			"w,w,w,w,w,w,w,w,w,w,w,w,w,w,w,w,w,w,w,w,w,w,w,w,w",
			"w, , , , , , , ,t,t,t,t,t,t,t, , , , , , , , , ,w",
			"w, , , , , , , , , , , , , , , , , , , , , , , ,w",
			"w, , , , , , , , , , , , , , , , , , , , , , , ,w",
			"w, , , , ,c, , , , ,s14,s13,s12,s11, , , , , , , , , , ,w",
			"w, , , , ,c, , , , , , , , , , , , , , , , , , ,w",
			"w, , , , ,c, , , , , , , , , , , , , , , , , , ,w",
			"w, , , , ,c, , , , ,t, , , ,t, , , , , ,c, , , ,w",
			"w, , , , ,c, , , , , , , , , , , , , , , , , , ,w",
			"w, , , , ,c, , , , , , ,h, , , ,m, , , , , , , ,w",
			"w, , , ,s31, , , , , , , , , , , , , , , ,s44, , , ,w",
			"w, , , ,s32, , , , ,m,m, , , , , , , , , ,s43, , , ,w",
			"w, , , ,s33, , , , , , , , , , , , , , , ,s42, , , ,w",
			"w, , , ,s34, , , ,b, , , , , , , , , , , ,s41, , , ,w",
			"w, , , , , , , , , , , , , , ,h, , , , , , , , ,w",
			"w, , , , , , , , ,t,t, , ,t, , , , , , , , , , ,w",
			"w, , , , , , ,m, , , , , , ,m, , , , , , , , , ,w",
			"w, , , , , , , ,c, , , , , , , , , , ,t, , , ,a,w",
			"w, , , ,a, , , , , , , , , ,t, , , ,b, , , , , ,w",
			"w, , , , , , , ,h, , , , , , , , , , , , , , , ,w",
			"w, , , , , , , , , ,s21,s22,s23,s24, , , , , , , , , , ,w",
			"w, , , , , , , , , , , , , , , , , , , , , , , ,w",
			"w, , , , , , , , , , , , , , , , , ,h, , , , , ,w",
			"w, , , , ,m, , , , , , ,m,m,m,m,m,m, , , , , , ,w",
			"w,w,w,w,w,w,w,w,w,w,w,w,w,w,w,w,w,w,w,w,w,w,w,w,w"],
		"item_rates": {"a": 6, "m": 2, "c": 2, "t": 2, "b": 1, "o": 0, "h": 0},
		"goal": "HIGHSCORE",
		"target": 100,
		"bg": "DESERT",
		"profiles": {}
	},
	{
		"name": "Holy Cross",
		"id": 1,
		"map": [
			"w,w,w,w,w,w,w,w,w,w,w,w,w,w,w,w,w,w,w,w,w,w,w,w,w",
			"w, , , , , , , , , , , , , , , , , , , , , , , ,w",
			"w, , , , , , , , , , , , , , , , , , , , , , , ,w",
			"w, , ,s14,s13,s12,s11, , , , , ,w, , , , , , , , ,s44, , ,w",
			"w, , , , , , , , , , , ,w, , , , , , , , ,s43, , ,w",
			"w, , , , , , , , , , , ,w, , , , , , , , ,s42, , ,w",
			"w, , , , , , , , , , , ,w, , , , , , , , ,s41, , ,w",
			"w, , , , , , , , , , , ,w, , , , , , , , , , , ,w",
			"w, , , , , , , , , , , ,w, , , , , , , , , , , ,w",
			"w, , , , , , , , , , , ,w, , , , , , , , , , , ,w",
			"w, , , , , , , , , , , ,w, , , , , , , , , , , ,w",
			"w, , , , , , , , , , , , , , , , , , , , , , , ,w",
			"w, , ,w,w,w,w,w,w,w,w, , , ,w,w,w,w,w,w,w,w, , ,w",
			"w, , , , , , , , , , , , , , , , , , , , , , , ,w",
			"w, , , , , , , , , , , ,w, , , , , , , , , , , ,w",
			"w, , , , , , , , , , , ,w, , , , , , , , , , , ,w",
			"w, , , , , , , , , , , ,w, , , , , , , , , , , ,w",
			"w, , , , , , , , , , , ,w, , , , , , , , , , , ,w",
			"w, , ,s31, , , , , , , , ,w, , , , , , , , , , , ,w",
			"w, , ,s32, , , , , , , , ,w, , , , , , , , , , , ,w",
			"w, , ,s33, , , , , , , , ,w, , , , , , , , , , , ,w",
			"w, , ,s34, , , , , , , , ,w, , , , , ,s21,s22,s23,s24, , ,w",
			"w, , , , , , , , , , , , , , , , , , , , , , , ,w",
			"w, , , , , , , , , , , , , , , , , , , , , , , ,w",
			"w,w,w,w,w,w,w,w,w,w,w,w,w,w,w,w,w,w,w,w,w,w,w,w,w"],	
		"item_rates": {"a": 4, "m": 2, "c": 3, "t": 2, "b": 2, "o": 1, "h": 1},
		"goal": "HIGHSCORE",
		"target": 100,
		"bg": "DESERT",
		"profiles": {}
	},
	{
		"name": "Running In Circles",
		"id": 2,
		"map": [
			"w,w,w,w,w,w,w,w,w,w,w,w,w,w,w,w,w,w,w,w,w,w,w,w,w",
			"w,m, , , , , , , , ,c, , , ,c, , , , , , , , ,m,w",
			"w, ,s14,s13,s12,s11, , , , , , ,c, , , , , , , , , ,s34, ,w",
			"w, , , , , , , , ,w,w,w,w,w,w,w, , , , , , ,s33, ,w",
			"w, , , , , , ,w,w, ,t, , , , , ,w,w, , , , ,s32, ,w",
			"w, , , , , ,a, , , , , , , , , , , ,a, , , ,s31, ,w",
			"w, , , , ,a, , , , , , , , ,t, , , , ,a, , , , ,w",
			"w, , , ,w, , , , , ,w,w,w,w,w, , , , , ,w, , , ,w",
			"w, , , ,w, , , , ,w, , , , , ,w, , , , ,w, , , ,w",
			"w, , ,w, , , , ,w, , , , , , , ,w, , , , ,w, , ,w",
			"w,c, ,w, , , ,w, , , ,w, ,w, , , ,w, , , ,w, ,c,w",
			"w, , ,w, , , , , , ,w,m,a,m,w, , , , , , ,w, , ,w",
			"w, ,c,w,t, , , , , ,w,b,a,b,w, , , , , , ,w,c, ,w",
			"w, , ,w, , , , , , ,w,m,a,m,w, , , , , , ,w, , ,w",
			"w,c, ,w, , , ,w, , , ,w, ,w, , , ,w, , , ,w, ,c,w",
			"w, , ,w, , , , ,w, , , , , , , ,w, , , , ,w, , ,w",
			"w, , , ,w, , , , ,w, , , , , ,w, , , , ,w, , , ,w",
			"w, , , ,w, , , , , ,w,w,w,w,w, , , , , ,w, , , ,w",
			"w, , , , ,a, , , , , , , , ,t, , , , ,a, , , , ,w",
			"w, ,s41, , , ,a, , , , , , , , , , , ,a, , , , , ,w",
			"w, ,s42, , , , ,w,w, ,t, , , , , ,w,w, , , , , , ,w",
			"w, ,s43, , , , , , ,w,w,w,w,w,w,w, , , , , , , , ,w",
			"w, ,s44, , , , , , , , , ,c, , , , , , ,s21,s22,s23,s24, ,w",
			"w,m, , , , , , , , ,c, , , ,c, , , , , , , , ,m,w",
			"w,w,w,w,w,w,w,w,w,w,w,w,w,w,w,w,w,w,w,w,w,w,w,w,w"],	
		"item_rates": {"a": 4, "m": 2, "c": 3, "t": 2, "b": 2, "o": 1, "h": 1},
		"goal": "HIGHSCORE",
		"target": 150,
		"bg": "DESERT",
		"profiles": {}
	},
	{
		"name": "Entry At Own Risk",
		"id": 3,
		"map": [
			"w,w,w,w,w,w,w,w,w,w,w,w,w,w,w,w,w,w,w,w,w,w,w,w,w",
			"w, , , , , , , , , ,m, ,m, ,m, , , , , , , , , ,w",
			"w, ,s14,s13,s12,s11, , , ,m, ,m, ,m, ,m, , , , , , ,s34, ,w",
			"w, , ,w,w, , , ,w, , , ,w, , , ,w, , , ,w,w,s33, ,w",
			"w, , ,w, , , ,w, , , ,w, ,w, , , ,w, , , ,w,s32, ,w",
			"w, , , , , ,w, , , , , , , , , , , ,w, , , ,s31, ,w",
			"w, , , , ,w, , , ,w, , , , , ,w, , , ,w, , , , ,w",
			"w, , , ,w, , , ,w, , , ,w, , , ,w, , , ,w, , , ,w",
			"w, , ,w, , , ,w, , , ,w, ,w, , , ,w, , , ,w, , ,w",
			"w, ,m, , , ,w, , , ,w, , , , , , , ,w, , , ,m, ,w",
			"w,m, , , , , , , , , , , , , ,w, , , , , , , ,m,w",
			"w, ,m, ,w, , , ,w, , , ,w, , , ,w, , , ,w, ,m, ,w",
			"w,m, ,w, , , ,w, , , ,w,w,w, , , ,w, , , ,w, ,m,w",
			"w, ,m, ,w, , , ,w, , , ,w, , , ,w, , , ,w, ,m, ,w",
			"w,m, , , , , , , ,w, , , , , , , , , , , , , ,m,w",
			"w, ,m, , , ,w, , , , , , , ,w, , , ,w, , , ,m, ,w",
			"w, , ,w, , , ,w, , , ,w, ,w, , , ,w, , , ,w, , ,w",
			"w, , , ,w, , , ,w, , , ,w, , , ,w, , , ,w, , , ,w",
			"w, , , , ,w, , , ,w, , , , , ,w, , , ,w, , , , ,w",
			"w, ,s41, , , ,w, , , , , , , , , , , ,w, , , , , ,w",
			"w, ,s42,w, , , ,w, , , ,w, ,w, , , ,w, , , ,w, , ,w",
			"w, ,s43,w,w, , , ,w, , , ,w, , , ,w, , , ,w,w, , ,w",
			"w, ,s44, , , , , , ,m, ,m, ,m, ,m, , , ,s21,s22,s23,s24, ,w",
			"w, , , , , , , , , ,m, ,m, ,m, , , , , , , , , ,w",
			"w,w,w,w,w,w,w,w,w,w,w,w,w,w,w,w,w,w,w,w,w,w,w,w,w"],	
		"item_rates": {"a": 0, "m": 1, "c": 1, "t": 0, "b": 1, "o": 5, "h": 1},
		"goal": "SURVIVE",
		"target": 180,
		"bg": "DESERT",
		"profiles": {}
	},
	{
		"name": "Labyrinths",
		"id": 4,
		"map": [
			"w,w,w,w,w,w,w,w,w,w,w,w,w,w,w,w,w,w,w,w,w,w,w,w,w",
			"w,s14,s13,s12,s11, , , , , , , , , , , , , , , , , , ,s34,w",
			"w, ,w,w,w,w,w,w,w,w,w, , , ,w,w,w,w,w,w,w,w,w,s33,w",
			"w, , , , , , , , , ,w, , , ,w, , , , , , , , ,s32,w",
			"w, ,w,w,w,w,w,w,w, ,w, , , ,w, ,w,w,w,w,w,w,w,s31,w",
			"w, ,w, , , , , , , ,w, , , ,w, , , , , , , ,w, ,w",
			"w, ,w, ,w,w,w,w,w,w,w, , , ,w,w,w,w,w,w,w, ,w, ,w",
			"w, ,w, , , , , , , ,w, , , ,w, , , , , , , ,w, ,w",
			"w, ,w,w,w,w,w,w,w, ,w, , , ,w, ,w,w,w,w,w,w,w, ,w",
			"w, ,w, , , , , , , ,w, , , ,w, , , , , , , ,w, ,w",
			"w, ,w, ,w,w,w,w,w,w,w, , , ,w,w,w,w,w,w,w, ,w, ,w",
			"w, , , , , , , , , , ,a,b,m, , , , , , , , , , ,w",
			"w, , , , , , , , , , ,c,w,c, , , , , , , , , , ,w",
			"w, , , , , , , , , , ,m,b,a, , , , , , , , , , ,w",
			"w, ,w, ,w,w,w,w,w,w,w, , , ,w,w,w,w,w,w,w, ,w, ,w",
			"w, ,w, , , , , , , ,w, , , ,w, , , , , , , ,w, ,w",
			"w, ,w,w,w,w,w,w,w, ,w, , , ,w, ,w,w,w,w,w,w,w, ,w",
			"w, ,w, , , , , , , ,w, , , ,w, , , , , , , ,w, ,w",
			"w, ,w, ,w,w,w,w,w,w,w, , , ,w,w,w,w,w,w,w, ,w, ,w",
			"w, ,w, , , , , , , ,w, , , ,w, , , , , , , ,w, ,w",
			"w,s41,w,w,w,w,w,w,w, ,w, , , ,w, ,w,w,w,w,w,w,w, ,w",
			"w,s42, , , , , , , , ,w, , , ,w, , , , , , , , , ,w",
			"w,s43,w,w,w,w,w,w,w,w,w, , , ,w,w,w,w,w,w,w,w,w, ,w",
			"w,s44, , , , , , , , , , , , , , , , , , ,s21,s22,s23,s24,w",
			"w,w,w,w,w,w,w,w,w,w,w,w,w,w,w,w,w,w,w,w,w,w,w,w,w"],	
		"item_rates": {"a": 4, "m": 2, "c": 3, "t": 2, "b": 2, "o": 1, "h": 1},
		"goal": "HIGHSCORE",
		"target": 300,
		"bg": "DESERT",
		"profiles": {}
	},
	{
		"name": "Stairway To Heaven",
		"id": 5,
		"map": [
			"w,w,w,w,w,w,w,w,w,w,w,w,w,w,w,w,w,w,w,w,w,w,w,w,w",
			"w,s14,s13,s12,s11, , , , , , , , , , , , , , , , , , ,s34,w",
			"w, , ,w, , ,w,w,w, , ,w,w,w, , ,w,w,w, , ,w, ,s33,w",
			"w, , , , , ,w, , , , ,w, , , , ,w, , , , ,w, ,s32,w",
			"w, , , ,w,w,w, , ,w,w,w, , ,w,w,w, , ,w,w,w, ,s31,w",
			"w, , , ,w, , , , ,w, , , , ,w, , , , ,w, , , , ,w",
			"w, , ,w,w, , ,w,w,w, , ,w,w,w, , ,w,w,w, , , , ,w",
			"w, , , , , , ,w, , , , ,w, , , , ,w, , , , , , ,w",
			"w, , , , ,w,w,w, , ,w,w,w, , ,w,w,w, , ,w,w, , ,w",
			"w, , , , ,w, , , , ,w, , , , ,w, , , , ,w, , , ,w",
			"w, , ,w,w,w, , ,w,w,w, , ,w,w,w, , ,w,w,w, , , ,w",
			"w, , ,w, , , , ,w, , , , ,w, , , , ,w, , , , , ,w",
			"w, , ,w, , ,w,w,w, , ,w,w,w, , ,w,w,w, , ,w, , ,w",
			"w, , , , , ,w, , , , ,w, , , , ,w, , , , ,w, , ,w",
			"w, , , ,w,w,w, , ,w,w,w, , ,w,w,w, , ,w,w,w, , ,w",
			"w, , , ,w, , , , ,w, , , , ,w, , , , ,w, , , , ,w",
			"w, , ,w,w, , ,w,w,w, , ,w,w,w, , ,w,w,w, , , , ,w",
			"w, , , , , , ,w, , , , ,w, , , , ,w, , , , , , ,w",
			"w, , , , ,w,w,w, , ,w,w,w, , ,w,w,w, , ,w,w, , ,w",
			"w, , , , ,w, , , , ,w, , , , ,w, , , , ,w, , , ,w",
			"w,s41, ,w,w,w, , ,w,w,w, , ,w,w,w, , ,w,w,w, , , ,w",
			"w,s42, ,w, , , , ,w, , , , ,w, , , , ,w, , , , , ,w",
			"w,s43, ,w, , ,w,w,w, , ,w,w,w, , ,w,w,w, , ,w, , ,w",
			"w,s44, , , , , , , , , , , , , , , , , , ,s21,s22,s23,s24,w",
			"w,w,w,w,w,w,w,w,w,w,w,w,w,w,w,w,w,w,w,w,w,w,w,w,w"],	
		"item_rates": {"a": 0, "m": 1, "c": 1, "t": 0, "b": 1, "o": 5, "h": 1},
		"drop_rate": 3,
		"goal": "SURVIVE",
		"target": 180,
		"bg": "DESERT",
		"profiles": {}
	},
	{
		"name": "Devil In Disguise",
		"id": 6,
		"map": [
			"w,w,w,w,w,w,w,w,w,w,w,w,w,w,w,w,w,w,w,w,w,w,w,w,w",
			"w, , , , , , , , , , , , , , , , , , , , , , , ,w",
			"w, , , , , , , , , , , , , , , , , , , , , , , ,w",
			"w, , ,s14,s13,s12,s11, , , , , , , , , , , , , , ,s34, , ,w",
			"w, , , , , , , , , , , , , , , , , , , , ,s33, , ,w",
			"w, , , , , , , , , , , , , , , , , , , , ,s32, , ,w",
			"w, , , , , , , , , , , , , , , , , , , , ,s31, , ,w",
			"w, , , , , , , , , , , , , , , , , , , , , , , ,w",
			"w, , , , , , , , , , , , , , , , , , , , , , , ,w",
			"w, , , , , , , , , , , , , , , , , , , , , , , ,w",
			"w, , , , , , , , , , , , , , , , , , , , , , , ,w",
			"w, , , , , , , , , , , , , , , , , , , , , , , ,w",
			"w, , , , , , , , , , , , , , , , , , , , , , , ,w",
			"w, , , , , , , , , , , , , , , , , , , , , , , ,w",
			"w, , , , , , , , , , , , , , , , , , , , , , , ,w",
			"w, , , , , , , , , , , , , , , , , , , , , , , ,w",
			"w, , , , , , , , , , , , , , , , , , , , , , , ,w",
			"w, , , , , , , , , , , , , , , , , , , , , , , ,w",
			"w, , ,s41, , , , , , , , , , , , , , , , , , , , ,w",
			"w, , ,s42, , , , , , , , , , , , , , , , , , , , ,w",
			"w, , ,s43, , , , , , , , , , , , , , , , , , , , ,w",
			"w, , ,s44, , , , , , , , , , , , , , ,s21,s22,s23,s24, , ,w",
			"w, , , , , , , , , , , , , , , , , , , , , , , ,w",
			"w, , , , , , , , , , , , , , , , , , , , , , , ,w",
			"w,w,w,w,w,w,w,w,w,w,w,w,w,w,w,w,w,w,w,w,w,w,w,w,w"],
		"item_rates": {"a": 0, "m": 0, "c": 3, "t": 0, "b": 1, "o": 5, "h": 1},
		"drop_rate": 0.5,
		"goal": "SURVIVE",
		"target": 120,
		"bg": "DESERT",
		"profiles": {}
	},
	{
		"name": "Smile When You're Happy",
		"id": 7,
		"map": [
			"w,w,w,w,w,w,w,w,w,w,w,w,w,w,w,w,w,w,w,w,w,w,w,w,w",
			"w,h, , , , , , , , , , , , , , , , , , , , , ,h,w",
			"w, , , ,w,w,w,w,w,w, , , , , ,w,w,w,w,w,w, , , ,w",
			"w, , ,w, , , , , , ,w, , , ,w, , , , , , ,w, , ,w",
			"w, , , , ,w,w,w,w, , , , , , , ,w,w,w,w, , , , ,w",
			"w, , , ,w, ,s14, , ,w, , , , , ,w, , ,s24, ,w, , , ,w",
			"w, , , ,w, ,s13, , ,w, , , , , ,w, , ,s23, ,w, , , ,w",
			"w, , , ,w, ,s12, , ,w, , , , , ,w, , ,s22, ,w, , , ,w",
			"w, , , ,w, ,s11, , ,w, , ,w, , ,w, , ,s21, ,w, , , ,w",
			"w, , , , ,w, , ,w, , , ,w, , , ,w, , ,w, , , , ,w",
			"w, , , , , , , , , , ,w,m,w, , , , , , , , , , ,w",
			"w, , , , , , , , , , ,w,m,w, , , , , , , , , , ,w",
			"w,t, , , , , , , , ,w,a,m,a,w, , , , , , , , ,t,w",
			"w, ,w, , , , , , , ,w,w,w,w,w, , , , , , , ,w, ,w",
			"w, ,w, , , , , , , , , , , , , , , , , , , ,w, ,w",
			"w, ,w,w,w,w,w, , , , , , , , , , , ,w,w,w,w,w, ,w",
			"w, , ,w, , , ,w,w,w,w, , , ,w,w,w,w, , , ,w, , ,w",
			"w, , ,w, ,s34,s33,s32,s31, , , , , , , ,s41,s42,s43,s44, ,w, , ,w",
			"w, , , ,w, , , , , , , , , , , , , , , ,w, , , ,w",
			"w, , , , ,w, , , , , , , , , , , , , ,w, , , , ,w",
			"w, , , , , ,w,w,w, ,a,c,m,c,a, ,w,w,w, , , , , ,w",
			"w, , , , , , , , ,w,w,w,w,w,w,w, , , , , , , , ,w",
			"w, , , , , , , , , , , , , , , , , , , , , , , ,w",
			"w,h, , , , , , , , , , , , , , , , , , , , , ,h,w",
			"w,w,w,w,w,w,w,w,w,w,w,w,w,w,w,w,w,w,w,w,w,w,w,w,w"],
		"item_rates": {"a": 2, "m": 2, "c": 3, "t": 2, "b": 2, "o": 3, "h": 3},
		"drop_rate": 3,
		"goal": "HIGHSCORE",
		"target": 500,
		"bg": "DESERT",
		"profiles": {}
	},
	{
		"name": "Christmas Apple Tree",
		"id": 8,
		"map": [
			"w,w,w,w,w,w,w,w,w,w,w,w,w,w,w,w,w,w,w,w,w,w,w,w,w",
			"w, , , , , , , , , , , , , , , , , , , , , , , ,w",
			"w, , , ,w, , , , , , , , , , , , , , , ,w, , , ,w",
			"w, , ,w,w,w, , , , , , ,w, , , , , , ,w,w,w, , ,w",
			"w, , , ,w, , , , , , ,w, ,w, , , , , , ,w, , , ,w",
			"w, , , , , , , , , ,w, , , ,w, , , , , , , , , ,w",
			"w, , , , , , , , ,w, , , , , ,w, , , , , , , , ,w",
			"w, , , , , , , ,w, , , , , , , ,w, , , , , , , ,w",
			"w, , , , , , ,w,w,w,w, , , ,w,w,w,w, , , , , , ,w",
			"w, , , , , , , , ,w,a,a,a,a,a,w, , , , , , , , ,w",
			"w, , , , , , , ,w,a,a,a,a,a,a,a,w, , , , , , , ,w",
			"w, , , , , , ,w,a,a,a,a,a,a,a,a,a,w, , , , , , ,w",
			"w, , , , , ,w, ,a,a,a,a,a,a,a,a,a, ,w, , , , , ,w",
			"w, , , , ,w,w,w,w,a,a,a,a,a,a,a,w,w,w,w, , , , ,w",
			"w, , , , , , ,w,a,a,a,a,a,a,a,a,a,w, , , , , , ,w",
			"w, , , , , ,w,a,a,a,a,a,a,a,a,a,a,a,w, , , , , ,w",
			"w, , , , ,w,a,a,a,a,a,a,a,a,a,a,a,a,a,w, , , , ,w",
			"w, , , ,w,a,a,a,s21,s22,s23,s24,w,s14,s13,s12,s11,a,a,a,w, , , ,w",
			"w, , ,w,w,w,w,w,w,w,w,a,m,a,w,w,w,w,w,w,w,w, , ,w",
			"w, , , , , , , , , ,w,a, ,a,w, , , , , , , , , ,w",
			"w, , , ,w, , , , , ,w,m,a,m,w, , , , , ,w, , , ,w",
			"w, , ,w,w,w, , , , ,w,a, ,a,w, , , , ,w,w,w, , ,w",
			"w, , , ,w, , , ,s41,s42,s43,s44,w,s34,s33,s32,s31, , , ,w, , , ,w",
			"w, , , , , , , , , , , , , , , , , , , , , , , ,w",
			"w,w,w,w,w,w,w,w,w,w,w,w,w,w,w,w,w,w,w,w,w,w,w,w,w"],
		"item_rates": {"a": 6, "m": 6, "c": 1, "t": 0, "b": 1, "o": 1, "h": 1},
		"drop_rate": 2,
		"goal": "SURVIVE",
		"target": 180,
		"bg": "DESERT",
		"profiles": {}
	},
	{
		"name": "No Wrong Turns",
		"id": 9,
		"map": [
			"w,w,w,w,w,w,w,w,w,w,w,w,w,w,w,w,w,w,w,w,w,w,w,w,w",
			"w, ,s41,s42,s43,s44, , , , , , , , , , , , , ,s14,s13,s12,s11, ,w",
			"w, ,w,w,w,w,w,w,w,w,w,w,w,w,w,w,w,w,w,w,w,w,w, ,w",
			"w, , , , , , , , , , , , , , , , , , , , , , , ,w",
			"w, ,w,w,w, ,w, ,w, ,w, ,w,w,w,w,w, ,w, ,w,w,w, ,w",
			"w, , , ,w, ,w, ,w, ,w, ,w, ,w, , , , , , , , , ,w",
			"w, ,w, ,w,w,w, ,w, , , ,w, , , , ,w, ,w, ,w,w, ,w",
			"w, ,w, , , , , ,w, ,w, ,w,w,w,w, ,w, ,w, , , , ,w",
			"w, ,w,w,w,w,w,w,w, ,w, , , , , , ,w, ,w, ,w,w, ,w",
			"w, , ,w, , , ,w, , ,w, ,w,w,w,w,w,w, , , , ,w, ,w",
			"w,w, ,w, ,w, ,w, ,w,w,w,w, , , ,w, , ,w,w, ,w, ,w",
			"w, , , , ,w, , , ,w, , , , ,w,w,w, , , , , ,w, ,w",
			"w, ,w, ,w,w, ,w,w,w, ,w,w, ,w, , , , ,w,w, ,w, ,w",
			"w, , , , ,w, , , ,w, , ,w, ,w, ,w,w, , , , ,w, ,w",
			"w,w, ,w, ,w, ,w, ,w,w, ,w, ,w, ,w, ,w, ,w, ,w, ,w",
			"w, , ,w, , , ,w, , , , ,w, ,w, ,w, , , ,w, ,w, ,w",
			"w, ,w,w,w,w,w,w,w,w,w,w,w, ,w, ,w,w,w,w,w, ,w, ,w",
			"w, ,w, , , , , ,w, , , ,w, ,w, , , , , , , , , ,w",
			"w, ,w, ,w,w,w, ,w, ,w, , , ,w, ,w,w, ,w, ,w,w, ,w",
			"w, , , ,w, ,w, ,w, ,w,w,w,w,w, , ,w, ,w, , ,w, ,w",
			"w, ,w,w,w, ,w, ,w, , , ,w, , , , ,w, ,w,w,w,w, ,w",
			"w, , , , , , , , , ,w, , , ,w, , ,w, , , , , , ,w",
			"w, ,w,w,w,w,w,w,w,w,w,w,w,w,w,w,w,w,w,w,w,w,w, ,w",
			"w, ,s21,s22,s23,s24, , , , , , , , , , , , , ,s34,s33,s32,s31, ,w",
			"w,w,w,w,w,w,w,w,w,w,w,w,w,w,w,w,w,w,w,w,w,w,w,w,w"],
		"item_rates": {"a": 3, "m": 3, "c": 1, "t": 2, "b": 2, "o": 0, "h": 2},
		"goal": "HIGHSCORE",
		"target": 500,
		"bg": "DESERT",
		"profiles": {}
	}
]